{
    "testLevel": {
        "rows": [
            "...................",
            ".#################.",
            ".#...............#.",
            ".#...............#.",
            ".#...............#.",
            ".#...............#.",
            ".#...............#.",
            ".#...............#.",
            ".#...............#.",
            ".#...............#.",
            ".#...............#.",
            ".#...............#.",
            ".#################.",
            "..................."
        ]
    },
    "outlineLevel": {
        "rows": [
            "###################",
            "#.................#",
            "#.................#",
            "#.................#",
            "#.................#",
            "#.................#",
            "#.................#",
            "#.................#",
            "#.................#",
            "#.................#",
            "#.................#",
            "#.................#",
            "#.................#",
            "#.................#",
            "###################"
        ]
    },
    "blankLevel": {
        "rows": [
            "...................",
            "...................",
            "...................",
            "...................",
            "...................",
            "...................",
            "...................",
            "...................",
            "...................",
            "...................",
            "...................",
            "...................",
            "...................",
            "..................."
        ]
    },
    "shopLevel": {
        "rows": [
            "###################",
            "#.................#",
            "#......p...p......#",
            "#........P........#",
            "#......p...p......#",
            "#........E........#",
            "#.................#",
            "#.................#",
            "#.................#",
            "#.................#",
            "#.................#",
            "#.................#",
            "#.................#",
            "#.................#",
            "###################"
        ]
    },
    "Level0": {
        "rows": [
            "###################",
            "#P.DbD.t###########",
            "#..#.#######cc..E##",
            "#t.D.D.t####c...E##",
            "####.#####E#.b..E##",
            "##b#.##....#....E##",
            "#..T.##.t..D..T.E##",
            "#.cc.##T...D..T.E##",
            "#.cc.##....#....E##",
            "#.cc.##D##E#c...E##",
            "#.cc.##.####cc..E##",
            "#.cc.##.###########",
            "#....D..###########",
            "###################"
        ]
    },
    "Level1": {
        "rows": [
            "###################",
            "#.................#",
            "#......p...p......#",
            "#........P........#",
            "#......p...p......#",
            "#........E........#",
            "#.................#",
            "#.................#",
            "#.................#",
            "#.................#",
            "#.................#",
            "#.................#",
            "#.................#",
            "#.................#",
            "###################"
        ],
        "shopContents": [
            "Torch-3",
            "Bomb-5",
            "HP-10",
            "HP-10"
        ]
    },
    "Level2": {
        "rows": [
            "###################",
            "#....D....t....c..#",
            "#.P..D.cc.......c.#",
            "#...c####.######.c#",
            "#..c#####.######.T#",
            "#DD######D######..#",
            "#..######T######..#",
            "#...D....b....D...#",
            "#..######T######T.#",
            "#DD######.######DD#",
            "#..######D######..#",
            "#c.######.######.c#",
            "#Tc........D....c.#",
            "#t.c.......D...c.E#",
            "###################"
        ]
    },
    "Level3": {
        "rows": [
            "###################",
            "#.................#",
            "#......p...p......#",
            "#........P........#",
            "#......p...p......#",
            "#........E........#",
            "#.................#",
            "#.................#",
            "#.................#",
            "#.................#",
            "#.................#",
            "#.................#",
            "#.................#",
            "#.................#",
            "###################"
        ],
        "shopContents": [
            "Torch-3",
            "Bomb-5",
            "HP-10",
            "HP-10"
        ]
    },
    "Level4": {
        "rows": [
            "###################",
            "#cc.T##...#bbbt#..#",
            "#t#.....#######...#",
            "##..#######.....#D#",
            "#..###cc###..#c.#.#",
            "#..#.........#.c#.#",
            "#.##.P.##D##.#c.#t#",
            "#.##...#T.E#.#.c#.#",
            "#.##...##D##.#c.#.#",
            "#D####....#..#.c#D#",
            "#....#D####..##...#",
            "###.T#c#T..#..T#.#",
            "#.....#D#...###...#",
            "#t###.....#.....#T#",
            "###################"
        ]
    },
    "Level5": {
        "rows": [
            "###################",
            "#.................#",
            "#.................#",
            "#..###..#..#..##..#",
            "#..#....##.#..#.#.#",
            "#..##...##.#..#.#.#",
            "#..#....#.##..#.#.#",
            "#..###..#..#..##..#",
            "#.................#",
            "#........P........#",
            "#.................#",
            "#.................#",
            "#.................#",
            "#.................#",
            "###################"
        ]
    }
}