{
    "testLevel": {
        "rows": [
            "...................",
            ".#################.",
            ".#...............#.",
            ".#...............#.",
            ".#...............#.",
            ".#...............#.",
            ".#...............#.",
            ".#...............#.",
            ".#...............#.",
            ".#...............#.",
            ".#...............#.",
            ".#...............#.",
            ".#################.",
            "..................."
        ]
    },
    "outlineLevel": {
        "rows": [
            "###################",
            "#.................#",
            "#.................#",
            "#.................#",
            "#.................#",
            "#.................#",
            "#.................#",
            "#.................#",
            "#.................#",
            "#.................#",
            "#.................#",
            "#.................#",
            "#.................#",
            "#.................#",
            "###################"
        ]
    },
    "blankLevel": {
        "rows": [
            "...................",
            "...................",
            "...................",
            "...................",
            "...................",
            "...................",
            "...................",
            "...................",
            "...................",
            "...................",
            "...................",
            "...................",
            "...................",
            "..................."
        ]
    },
    "Level0": {
        "rows": [
            "###################",
            "#.......###########",
            "####.#######....E##",
            "#.......####....E##",
            "####.#####E#....E##",
            "##.#.##....#....E##",
            "#....##.........E##",
            "#....##.........E##",
            "#....##....#....E##",
            "#....##.##E#....E##",
            "#....##.####....E##",
            "#.E..##.###########",
            "#.......###########",
            "###################"
        ]
    },
    "Level1": {
        "rows": [
            "###################",
            "#.................#",
            "#.................#",
            "#..#############..#",
            "#..#############..#",
            "#..#############..#",
            "#..#############..#",
            "#..#############..#",
            "#..#############..#",
            "#..#############..#",
            "#..#############..#",
            "#.................#",
            "#.................#",
            "###################"
        ]
    }
}