{
    "testLevel": {
        "rows": [
            "...................",
            ".#################.",
            ".#...............#.",
            ".#...............#.",
            ".#...............#.",
            ".#...............#.",
            ".#...............#.",
            ".#...............#.",
            ".#...............#.",
            ".#...............#.",
            ".#...............#.",
            ".#...............#.",
            ".#################.",
            "..................."
        ]
    },
    "outlineLevel": {
        "rows": [
            "###################",
            "#.................#",
            "#.................#",
            "#.................#",
            "#.................#",
            "#.................#",
            "#.................#",
            "#.................#",
            "#.................#",
            "#.................#",
            "#.................#",
            "#.................#",
            "#.................#",
            "#.................#",
            "###################"
        ]
    },
    "blankLevel": {
        "rows": [
            "...................",
            "...................",
            "...................",
            "...................",
            "...................",
            "...................",
            "...................",
            "...................",
            "...................",
            "...................",
            "...................",
            "...................",
            "...................",
            "..................."
        ]
    },
    "Level0": {
        "rows": [
            "###################",
            "#P.D.D.t###########",
            "#.B#.#######cc..E##",
            "#t.D.D.t####c...E##",
            "####.#####E#....E##",
            "##.#.##....#....E##",
            "#..T.##.t..D....E##",
            "#.cc.##....D....E##",
            "#.cc.##....#....E##",
            "#.cc.##D##E#c...E##",
            "#.cc.##.####cc..E##",
            "#.cc.##.###########",
            "#....D..###########",
            "###################"
        ]
    },
    "Level1": {
        "rows": [
            "###################",
            "#....D....t....c..#",
            "#.P..D.cc.......c.#",
            "#...c####.######.c#",
            "#..c#####.######..#",
            "#DD######D######..#",
            "#..######.######..#",
            "#...D....t....D...#",
            "#..######.######..#",
            "#DD######.######DD#",
            "#..######D######..#",
            "#c.######.######.c#",
            "#.c........D....c.#",
            "#..c.......D...c.E#",
            "###################"
        ]
    },
    "Level2": {
        "rows": [
            "###################",
            "#cc..##...#.......#",
            "#t#.....###.......#",
            "##..#######.....#D#",
            "#..###..###..#c.#.#",
            "#..#.........#.c#.#",
            "#.##.P.##D##.#c.#t#",
            "#.##...#..E#.#.c#.#",
            "#.##...##D##.#c.#.#",
            "#D####....#..#.c#D#",
            "#....##D###..##...#",
            "###...#c#...#...#.#",
            "#.....#D#...###...#",
            "#t###.....#.....#.#",
            "###################"
        ]
    }
}