{
    "testLevel": {
        "rows": [
            "...................",
            ".#################.",
            ".#...............#.",
            ".#...............#.",
            ".#...............#.",
            ".#...............#.",
            ".#...............#.",
            ".#...............#.",
            ".#...............#.",
            ".#...............#.",
            ".#...............#.",
            ".#...............#.",
            ".#################.",
            "..................."
        ]
    },
    "outlineLevel": {
        "rows": [
            "###################",
            "#.................#",
            "#.................#",
            "#.................#",
            "#.................#",
            "#.................#",
            "#.................#",
            "#.................#",
            "#.................#",
            "#.................#",
            "#.................#",
            "#.................#",
            "#.................#",
            "#.................#",
            "###################"
        ]
    },
    "blankLevel": {
        "rows": [
            "...................",
            "...................",
            "...................",
            "...................",
            "...................",
            "...................",
            "...................",
            "...................",
            "...................",
            "...................",
            "...................",
            "...................",
            "...................",
            "..................."
        ]
    },
    "Level0": {
        "rows": [
            "###################",
            "#P.D.D.t###########",
            "####.#######cc..E##",
            "#t.D.D.t####c...E##",
            "####.#####E#....E##",
            "##.#.##....#....E##",
            "#....##.t..D....E##",
            "#.cc.##....D....E##",
            "#.cc.##....#....E##",
            "#.cc.##D##E#c...E##",
            "#.cc.##.####cc..E##",
            "#.cc.##.###########",
            "#....D..###########",
            "###################"
        ]
    },
    "Level1": {
        "rows": [
            "###################",
            "#P...Dccc.t.......#",
            "#..E.D............#",
            "#DD#############..#",
            "#..#############..#",
            "#..#############..#",
            "#..#############..#",
            "#..#############..#",
            "#..#############..#",
            "#..#############..#",
            "#..#############..#",
            "#.................#",
            "#.................#",
            "###################"
        ]
    }
}